file,BL_P,BL_N,BL_NET,BL_SENTIMENT,M_P,M_N,M_NET,M_SENTIMENT,M_UNCERTAINTY,M_LITIGIOUS,M_CONSTRAINING,M_SUPERFLUOUS,M_INTERESTING,M_MODAL
"1-22nd Century Group, Inc..txt",81,70,11,POSITIVE,26,48,-22,NEGATIVE,12,19,14,0,1,11
"1001-Matson, Inc..txt",185,144,41,POSITIVE,64,79,-15,NEGATIVE,34,36,32,0,7,23
1002-Mead Johnson Nutrition Co.txt,318,235,83,POSITIVE,133,129,4,POSITIVE,59,61,48,0,10,42
"1007-Mondelez International, Inc..txt",429,336,93,POSITIVE,175,204,-29,NEGATIVE,85,79,74,0,16,57
"1008-Motorola Solutions, Inc..txt",540,442,98,POSITIVE,216,277,-61,NEGATIVE,111,102,93,0,25,66
1009-Murphy USA Inc..txt,640,530,110,POSITIVE,246,336,-90,NEGATIVE,130,128,114,0,27,78
101-APPLIED MATERIALS INC  DE.txt,773,642,131,POSITIVE,303,413,-110,NEGATIVE,163,154,143,0,33,98
1010-NACCO INDUSTRIES INC.txt,881,743,138,POSITIVE,344,468,-124,NEGATIVE,187,183,174,0,40,119
1011-NANOMETRICS INC.txt,968,820,148,POSITIVE,376,519,-143,NEGATIVE,205,199,192,0,43,131
1014-NATIONAL BANKSHARES INC.txt,1029,878,151,POSITIVE,401,552,-151,NEGATIVE,216,208,202,0,47,137
1017-NATIONAL PENN BANCSHARES INC.txt,1127,961,166,POSITIVE,433,601,-168,NEGATIVE,231,226,222,0,52,150
"1018-NATIONAL RETAIL PROPERTIES, INC..txt",1201,1019,182,POSITIVE,461,630,-169,NEGATIVE,247,238,235,0,56,159
102-APTARGROUP INC.txt,1297,1103,194,POSITIVE,495,666,-171,NEGATIVE,264,252,252,0,63,172
1020-NATURES SUNSHINE PRODUCTS INC.txt,1393,1190,203,POSITIVE,538,732,-194,NEGATIVE,286,274,268,0,68,185
"1021-NAUTILUS, INC..txt",1465,1270,195,POSITIVE,563,775,-212,NEGATIVE,300,292,286,0,71,194
1025-NEW YORK MORTGAGE TRUST INC.txt,1576,1349,227,POSITIVE,596,815,-219,NEGATIVE,316,313,300,0,76,207
1027-NEWFIELD EXPLORATION CO  DE.txt,1691,1441,250,POSITIVE,643,868,-225,NEGATIVE,345,336,318,0,80,223
1029-NEWMARKET CORP.txt,1784,1510,274,POSITIVE,680,899,-219,NEGATIVE,354,350,333,0,85,232
1035-NOBLE ENERGY INC.txt,1889,1626,263,POSITIVE,716,962,-246,NEGATIVE,376,383,353,1,91,245
1036-NOODLES _ Co.txt,1889,1626,263,POSITIVE,716,962,-246,NEGATIVE,376,383,353,1,91,245
"104-AQUINOX PHARMACEUTICALS, INC.txt",1903,1649,254,POSITIVE,726,975,-249,NEGATIVE,376,383,355,1,91,246
1042-NORTHEAST UTILITIES.txt,2030,1736,294,POSITIVE,778,1029,-251,NEGATIVE,398,403,379,1,96,262
1048-NORWOOD FINANCIAL CORP.txt,2094,1787,307,POSITIVE,793,1054,-261,NEGATIVE,409,412,389,1,99,272
"1051-NRG Yield, Inc..txt",2094,1787,307,POSITIVE,793,1054,-261,NEGATIVE,409,412,389,1,99,272
1052-NUCOR CORP.txt,2169,1867,302,POSITIVE,828,1096,-268,NEGATIVE,429,427,404,1,105,285
107-ARCBEST CORP  DE.txt,2276,1972,304,POSITIVE,868,1152,-284,NEGATIVE,450,454,427,1,113,299
1073-NVR INC.txt,2371,2064,307,POSITIVE,901,1211,-310,NEGATIVE,468,470,449,1,115,314
"1075-National CineMedia, Inc..txt",2439,2127,312,POSITIVE,924,1244,-320,NEGATIVE,482,483,458,1,119,321
1082-Noble Corp plc.txt,2557,2224,333,POSITIVE,978,1314,-336,NEGATIVE,501,512,488,1,126,337
110-ARCHER DANIELS MIDLAND CO.txt,2688,2328,360,POSITIVE,1037,1375,-338,NEGATIVE,523,542,511,2,134,350
"1111-Nuverra Environmental Solutions, Inc..txt",2803,2431,372,POSITIVE,1078,1447,-369,NEGATIVE,552,576,530,2,137,370
1112-O REILLY AUTOMOTIVE INC.txt,2893,2509,384,POSITIVE,1111,1494,-383,NEGATIVE,568,592,550,3,140,382
1114-OCEANFIRST FINANCIAL CORP.txt,3004,2603,401,POSITIVE,1150,1542,-392,NEGATIVE,589,618,567,3,144,393
1115-OFG BANCORP.txt,3080,2660,420,POSITIVE,1176,1570,-394,NEGATIVE,603,641,582,3,149,404
1116-OGE ENERGY CORP..txt,3170,2738,432,POSITIVE,1209,1618,-409,NEGATIVE,625,664,597,3,153,419
1117-OLD NATIONAL BANCORP IN.txt,3285,2849,436,POSITIVE,1263,1684,-421,NEGATIVE,654,687,616,3,165,437
1119-OLIN CORP.txt,3401,2973,428,POSITIVE,1303,1773,-470,NEGATIVE,689,728,649,3,175,458
1120-OLYMPIC STEEL INC.txt,3494,3042,452,POSITIVE,1333,1808,-475,NEGATIVE,703,743,666,3,179,470
1121-OMNOVA SOLUTIONS INC.txt,3626,3157,469,POSITIVE,1388,1879,-491,NEGATIVE,733,768,689,3,185,485
1125-ORBCOMM Inc..txt,3735,3248,487,POSITIVE,1420,1940,-520,NEGATIVE,753,790,716,3,187,496
1130-Oasis Petroleum Inc..txt,3849,3340,509,POSITIVE,1471,1994,-523,NEGATIVE,772,817,739,3,194,512
1137-Otter Tail Corp.txt,3937,3414,523,POSITIVE,1500,2035,-535,NEGATIVE,792,827,759,3,199,525
1138-Owens Corning.txt,4054,3506,548,POSITIVE,1543,2104,-561,NEGATIVE,812,853,783,4,201,539
1139-PACCAR INC.txt,4135,3579,556,POSITIVE,1585,2154,-569,NEGATIVE,823,871,795,5,205,548
1143-PACIFIC GAS _ ELECTRIC Co.txt,4243,3685,558,POSITIVE,1619,2238,-619,NEGATIVE,843,898,822,5,211,561
1145-PAM TRANSPORTATION SERVICES INC.txt,4319,3746,573,POSITIVE,1643,2270,-627,NEGATIVE,854,910,839,5,211,571
1148-PARAGON OFFSHORE PLC.txt,4416,3845,571,POSITIVE,1681,2325,-644,NEGATIVE,872,938,865,5,216,584
1151-PARKER DRILLING CO  DE.txt,4539,3968,571,POSITIVE,1732,2406,-674,NEGATIVE,900,965,892,7,222,598
1157-PEABODY ENERGY CORP.txt,4676,4100,576,POSITIVE,1790,2501,-711,NEGATIVE,932,1001,923,8,234,615
1158-PEAPACK GLADSTONE FINANCIAL CORP.txt,4776,4182,594,POSITIVE,1824,2536,-712,NEGATIVE,943,1017,940,8,243,626
1159-PENNS WOODS BANCORP INC.txt,4835,4248,587,POSITIVE,1846,2566,-720,NEGATIVE,951,1031,953,8,252,636
1161-PENTAIR plc.txt,4941,4338,603,POSITIVE,1888,2629,-741,NEGATIVE,971,1049,978,8,258,650
1164-PEOPLES FINANCIAL CORP  MS.txt,5004,4396,608,POSITIVE,1912,2656,-744,NEGATIVE,981,1059,986,8,264,659
1168-PFIZER INC.txt,5144,4516,628,POSITIVE,1972,2732,-760,NEGATIVE,1014,1083,1011,9,271,679
1172-PIEDMONT NATURAL GAS CO INC.txt,5277,4614,663,POSITIVE,2022,2781,-759,NEGATIVE,1033,1102,1036,10,278,694
1182-PITNEY BOWES INC  DE.txt,5417,4732,685,POSITIVE,2078,2863,-785,NEGATIVE,1062,1139,1064,12,281,712
1184-PLUM CREEK TIMBER CO INC.txt,5545,4839,706,POSITIVE,2126,2943,-817,NEGATIVE,1085,1162,1090,12,286,731
1185-PLY GEM HOLDINGS INC.txt,5616,4905,711,POSITIVE,2157,2975,-818,NEGATIVE,1096,1174,1099,12,289,739
1186-PMC SIERRA INC.txt,5736,5002,734,POSITIVE,2204,3042,-838,NEGATIVE,1116,1202,1123,12,296,756
1190-POOL CORP.txt,5847,5091,756,POSITIVE,2251,3087,-836,NEGATIVE,1148,1212,1142,12,300,775
1191-POPULAR INC.txt,5999,5224,775,POSITIVE,2323,3168,-845,NEGATIVE,1173,1254,1174,13,311,790
1192-PORTLAND GENERAL ELECTRIC CO  OR.txt,6093,5312,781,POSITIVE,2354,3218,-864,NEGATIVE,1192,1273,1197,13,316,804
1192-POWELL INDUSTRIES INC.txt,6178,5383,795,POSITIVE,2384,3255,-871,NEGATIVE,1207,1286,1219,13,319,818
1201-PPG INDUSTRIES INC.txt,6291,5483,808,POSITIVE,2434,3320,-886,NEGATIVE,1234,1312,1241,13,324,831
1203-PREFERRED APARTMENT COMMUNITIES INC.txt,6343,5545,798,POSITIVE,2451,3344,-893,NEGATIVE,1247,1323,1255,13,324,839
1204-PREFORMED LINE PRODUCTS CO.txt,6429,5604,825,POSITIVE,2479,3366,-887,NEGATIVE,1267,1335,1271,13,326,848
1206-PRICE T ROWE GROUP INC.txt,6550,5685,865,POSITIVE,2532,3400,-868,NEGATIVE,1288,1347,1289,13,332,864
1210-PROGRESSIVE CORP OH.txt,6651,5785,866,POSITIVE,2573,3471,-898,NEGATIVE,1320,1370,1315,14,338,885
1214-PRUDENTIAL FINANCIAL INC.txt,6803,5921,882,POSITIVE,2630,3557,-927,NEGATIVE,1354,1401,1338,16,346,907
1217-PTC INC..txt,6893,6014,879,POSITIVE,2664,3609,-945,NEGATIVE,1377,1423,1354,16,352,920
1218-PUBLIC SERVICE ENTERPRISE GROUP INC.txt,7032,6130,902,POSITIVE,2726,3678,-952,NEGATIVE,1403,1452,1379,16,357,942
1219-PUBLIX SUPER MARKETS INC.txt,7088,6179,909,POSITIVE,2744,3707,-963,NEGATIVE,1417,1462,1389,16,359,953
1220-PULTEGROUP INC MI.txt,7204,6265,939,POSITIVE,2790,3752,-962,NEGATIVE,1441,1493,1411,16,363,968
"1231-Pathdiner Bancorp, Inc..txt",7204,6265,939,POSITIVE,2790,3752,-962,NEGATIVE,1441,1493,1411,16,363,968
"1233-People's United Financial, Inc..txt",7303,6358,945,POSITIVE,2828,3799,-971,NEGATIVE,1477,1509,1427,16,369,989
1238-Physicians Realty Trust.txt,7303,6358,945,POSITIVE,2828,3799,-971,NEGATIVE,1477,1509,1427,16,369,989
"1239-Piedmont Office Realty Trust, Inc..txt",7417,6448,969,POSITIVE,2870,3845,-975,NEGATIVE,1494,1524,1452,17,376,1003
1262-QUAKER CHENICAL CORP.txt,7539,6576,963,POSITIVE,2919,3931,-1012,NEGATIVE,1524,1566,1474,17,386,1021
1263 - QUALCOMM INC DE.txt,7650,6675,975,POSITIVE,2965,3994,-1029,NEGATIVE,1553,1593,1498,17,390,1039
1264 - QUICKLOGIC CORPORATION.txt,7732,6746,986,POSITIVE,2993,4029,-1036,NEGATIVE,1565,1612,1518,17,391,1048
1266 - Quanex Building Products CORP.txt,7856,6881,975,POSITIVE,3041,4132,-1091,NEGATIVE,1598,1662,1547,17,397,1067
1269 - RAMCO GERSHENSON PROPERTIES TRUST.txt,7960,6974,986,POSITIVE,3081,4185,-1104,NEGATIVE,1618,1693,1574,17,406,1083
127-AT_T INC..txt,8064,7075,989,POSITIVE,3112,4247,-1135,NEGATIVE,1631,1719,1599,17,412,1092
1270 - RAND CAPITAL CORP.txt,8141,7136,1005,POSITIVE,3138,4287,-1149,NEGATIVE,1651,1732,1621,17,413,1102
1271 - RAYMOND JAMES FINANCIAL INC.txt,8272,7235,1037,POSITIVE,3207,4348,-1141,NEGATIVE,1675,1752,1645,17,418,1119
1275 - REALOGY HOLDINGS CORP..txt,8394,7368,1026,POSITIVE,3241,4432,-1191,NEGATIVE,1706,1772,1671,17,422,1137
1276 - REALTY INCOME CORP.txt,8506,7458,1048,POSITIVE,3291,4492,-1201,NEGATIVE,1724,1795,1684,17,427,1150
1281 - REGENCY CENTERS CORP.txt,8599,7534,1065,POSITIVE,3325,4538,-1213,NEGATIVE,1747,1805,1711,17,432,1166
1286 - RETAIL OPPORTUNITY INVESTMENTS CORP.txt,8692,7597,1095,POSITIVE,3355,4566,-1211,NEGATIVE,1758,1821,1724,17,434,1176
1289 - REYNOLDS AMERICAN INC.txt,8829,7723,1106,POSITIVE,3403,4658,-1255,NEGATIVE,1788,1852,1760,18,439,1192
1290 - RIGEL PHARMACEUTICALS INC.txt,8948,7810,1138,POSITIVE,3439,4694,-1255,NEGATIVE,1810,1877,1775,19,447,1207
1293 - RLJ Lodging Trust.txt,9044,7884,1160,POSITIVE,3477,4722,-1245,NEGATIVE,1828,1891,1788,19,449,1221
1298 - ROGERS CORP.txt,9135,7960,1175,POSITIVE,3518,4760,-1242,NEGATIVE,1840,1905,1797,19,451,1234
1299 - ROLLINS INC.txt,9198,8013,1185,POSITIVE,3535,4794,-1259,NEGATIVE,1849,1919,1813,19,455,1246
130-AUTOLIV INC.txt,9341,8128,1213,POSITIVE,3581,4854,-1273,NEGATIVE,1874,1947,1837,20,463,1262
1301 - ROWAN COMPANIES PLC.txt,9478,8257,1221,POSITIVE,3626,4943,-1317,NEGATIVE,1901,1983,1863,21,469,1279
"1305 - RTI SURGICAL, INC..txt",9544,8308,1236,POSITIVE,3653,4958,-1305,NEGATIVE,1908,1992,1869,22,469,1287
1307 - RYLAND GROUP INC.txt,9626,8396,1230,POSITIVE,3676,5003,-1327,NEGATIVE,1922,2017,1895,22,472,1297
"1308 - Radius Health, Inc..txt",9704,8465,1239,POSITIVE,3698,5038,-1340,NEGATIVE,1936,2029,1902,22,475,1305
"1318 - Rouse Properties, Inc..txt",9781,8522,1259,POSITIVE,3727,5063,-1336,NEGATIVE,1941,2037,1912,22,479,1314
"132-AVIAT NETWORKS, INC..txt",9879,8590,1289,POSITIVE,3759,5118,-1359,NEGATIVE,1959,2056,1930,22,484,1326
1324 - SANDERSON FARMS INC.txt,10015,8714,1301,POSITIVE,3811,5219,-1408,NEGATIVE,1997,2081,1958,23,494,1355
1326 - SANMINA CORP.txt,10085,8789,1296,POSITIVE,3837,5270,-1433,NEGATIVE,2011,2097,1973,24,498,1366
1328 - SAUL CENTERS INC.txt,10135,8834,1301,POSITIVE,3846,5297,-1451,NEGATIVE,2014,2104,1975,24,498,1373
1331 - SCHLUMBERGER LTD  NV.txt,10265,8951,1314,POSITIVE,3902,5374,-1472,NEGATIVE,2045,2129,2003,24,506,1393
1335 - SEABOARD CORP  DE.txt,10297,8990,1307,POSITIVE,3913,5393,-1480,NEGATIVE,2049,2141,2007,24,510,1399
1339 - SELECT MEDICAL HOLDINGS CORP.txt,10414,9105,1309,POSITIVE,3943,5459,-1516,NEGATIVE,2076,2181,2033,25,516,1419
1340 - SELECTIVE INSURANCE GROUP INC.txt,10530,9217,1313,POSITIVE,3993,5529,-1536,NEGATIVE,2104,2217,2057,25,521,1432
1342 - SENIOR HOUSING PROPERTIES TRUST.txt,10575,9269,1306,POSITIVE,4005,5549,-1544,NEGATIVE,2115,2224,2067,25,523,1438
1348 - SHERWIN WILLIAMS CO.txt,10689,9363,1326,POSITIVE,4053,5608,-1555,NEGATIVE,2141,2249,2084,25,527,1454
135-AVISTA CORP.txt,10790,9461,1329,POSITIVE,4097,5664,-1567,NEGATIVE,2164,2269,2105,25,535,1472
1350 - SHORE BANCSHARES INC.txt,10883,9577,1306,POSITIVE,4118,5738,-1620,NEGATIVE,2186,2305,2130,26,541,1483
1352 - SILICON LABORATORIES INC.txt,10988,9666,1322,POSITIVE,4155,5795,-1640,NEGATIVE,2209,2324,2150,26,545,1498
"1353 - SILVER BULL RESOURCES, INC..txt",11048,9716,1332,POSITIVE,4175,5820,-1645,NEGATIVE,2225,2345,2154,26,546,1505
1359 - SMITH A O CORP.txt,11140,9809,1331,POSITIVE,4214,5865,-1651,NEGATIVE,2252,2361,2172,26,550,1522
1360 - SNAP-ON Inc.txt,11261,9915,1346,POSITIVE,4273,5926,-1653,NEGATIVE,2283,2397,2195,27,559,1540
1362 - SONIC AUTOMOTIVE INC.txt,11329,9987,1342,POSITIVE,4294,5966,-1672,NEGATIVE,2300,2417,2210,28,563,1553
1363 - SONIC FOUNDRY INC.txt,11393,10043,1350,POSITIVE,4319,6001,-1682,NEGATIVE,2310,2438,2216,28,568,1559
1364 - SONOCO PRODUCTS CO.txt,11524,10173,1351,POSITIVE,4374,6075,-1701,NEGATIVE,2340,2474,2242,30,575,1581
1365 - SOTHEBYS.txt,11677,10287,1390,POSITIVE,4442,6150,-1708,NEGATIVE,2374,2501,2270,30,581,1601
1366 - SOUTH JERSEY INDUSTRIES INC.txt,11783,10384,1399,POSITIVE,4490,6211,-1721,NEGATIVE,2396,2528,2291,30,588,1616
1369 - SOUTHERN COPPER CORP.txt,11868,10452,1416,POSITIVE,4518,6241,-1723,NEGATIVE,2411,2546,2305,30,594,1629
1372 - SOUTHWEST GAS CORP.txt,11986,10550,1436,POSITIVE,4562,6289,-1727,NEGATIVE,2431,2569,2332,31,601,1643
1374 - SPAN AMERICA MEDICAL SYSTEMS INC.txt,12075,10642,1433,POSITIVE,4597,6330,-1733,NEGATIVE,2453,2587,2352,31,605,1662
1377 - SPS COMMERCE INC.txt,12163,10709,1454,POSITIVE,4629,6356,-1727,NEGATIVE,2466,2596,2369,32,607,1672
1378 - SPX CORP.txt,12331,10848,1483,POSITIVE,4688,6470,-1782,NEGATIVE,2505,2636,2401,32,614,1694
138-AbbVie Inc..txt,12442,10953,1489,POSITIVE,4735,6517,-1782,NEGATIVE,2529,2659,2433,34,623,1713
1380 - ST JUDE MEDICAL INC.txt,12562,11059,1503,POSITIVE,4775,6589,-1814,NEGATIVE,2559,2687,2455,36,629,1729
"1385 - STANLEY BLACK & DECKER, INC..txt",12670,11154,1516,POSITIVE,4820,6649,-1829,NEGATIVE,2587,2711,2479,36,632,1747
1386 - STARBUCKS CORP.txt,12675,11163,1512,POSITIVE,4823,6651,-1828,NEGATIVE,2587,2712,2479,36,632,1748
1391 - STEEL DYNAMICS INC.txt,12799,11265,1534,POSITIVE,4873,6719,-1846,NEGATIVE,2614,2725,2499,37,638,1766
"1396 - STR HOLDINGS, INC..txt",12871,11342,1529,POSITIVE,4893,6756,-1863,NEGATIVE,2631,2736,2519,37,642,1776
1398 - STRAYER EDUCATION INC.txt,12947,11416,1531,POSITIVE,4922,6801,-1879,NEGATIVE,2646,2763,2537,37,643,1786
"140-Advanced BioEnergy, LLC.txt",12990,11452,1538,POSITIVE,4938,6813,-1875,NEGATIVE,2651,2771,2545,37,645,1791
1401 - STURM RUGER & CO INC.txt,13128,11582,1546,POSITIVE,4986,6888,-1902,NEGATIVE,2674,2819,2564,39,656,1808
1403 - SUNTRUST BANKS INC.txt,13244,11692,1552,POSITIVE,5038,6967,-1929,NEGATIVE,2700,2843,2593,39,663,1824
1407 - SVB FINANCIAL GROUP.txt,13333,11772,1561,POSITIVE,5072,7008,-1936,NEGATIVE,2713,2867,2610,39,666,1834
1408 - SYNNEX CORP.txt,13413,11844,1569,POSITIVE,5102,7045,-1943,NEGATIVE,2734,2880,2620,40,671,1847
1409 - SYNOPSYS INC.txt,13535,11946,1589,POSITIVE,5153,7111,-1958,NEGATIVE,2765,2901,2647,40,678,1865
1410 - SYNOVUS FINANCIAL CORP.txt,13625,12040,1585,POSITIVE,5180,7161,-1981,NEGATIVE,2786,2919,2674,40,685,1883
1414 - Select Income REIT.txt,13664,12091,1573,POSITIVE,5191,7182,-1991,NEGATIVE,2795,2926,2684,40,687,1888
1415 - SemiLEDs Corp.txt,13698,12142,1556,POSITIVE,5201,7220,-2019,NEGATIVE,2798,2945,2689,40,688,1891
"1419 - Smart & Final Stores, Inc..txt",13776,12222,1554,POSITIVE,5225,7260,-2035,NEGATIVE,2807,2964,2705,40,694,1900
1423 - Spectra Energy Corp..txt,13902,12319,1583,POSITIVE,5273,7317,-2044,NEGATIVE,2829,2985,2723,42,700,1915
"1426 - StarTek, Inc..txt",13984,12390,1594,POSITIVE,5305,7365,-2060,NEGATIVE,2843,2997,2738,43,704,1929
"1427 - Stellar Biotechnologies, Inc..txt",14039,12436,1603,POSITIVE,5323,7380,-2057,NEGATIVE,2851,3005,2746,44,707,1938
1437 - Symetra Financial CORP.txt,14132,12513,1619,POSITIVE,5354,7413,-2059,NEGATIVE,2864,3023,2760,45,711,1949
"1438 - Synutra International, Inc..txt",14170,12547,1623,POSITIVE,5363,7426,-2063,NEGATIVE,2873,3030,2765,45,712,1955
"1441 - TAL International Group, Inc..txt",14229,12615,1614,POSITIVE,5379,7460,-2081,NEGATIVE,2888,3046,2785,45,717,1964
1445 - TD AMERITRADE HOLDING CORP.txt,14311,12693,1618,POSITIVE,5405,7510,-2105,NEGATIVE,2899,3059,2800,45,720,1974
1446 - TE Connectivity Ltd..txt,14419,12806,1613,POSITIVE,5447,7580,-2133,NEGATIVE,2923,3091,2830,46,727,1990
1449 - TECUMSEH PRODUCTS CO.txt,14498,12902,1596,POSITIVE,5475,7639,-2164,NEGATIVE,2949,3111,2853,46,733,2008
1451 - TELEDYNE TECHNOLOGIES INC.txt,14603,13014,1589,POSITIVE,5519,7712,-2193,NEGATIVE,2978,3137,2878,47,740,2029
1454 - TENET HEALTHCARE CORP.txt,14724,13120,1604,POSITIVE,5568,7784,-2216,NEGATIVE,3004,3162,2902,49,748,2045
1455 - TENNANT CO.txt,14830,13230,1600,POSITIVE,5599,7853,-2254,NEGATIVE,3030,3197,2928,49,755,2061
1458 - TESSERA TECHNOLOGIES INC.txt,14948,13319,1629,POSITIVE,5635,7905,-2270,NEGATIVE,3049,3221,2951,50,760,2076
"146-Alon USA Energy, Inc..txt",15001,13364,1637,POSITIVE,5649,7918,-2269,NEGATIVE,3053,3229,2956,50,762,2082
1460 - TETRA TECHNOLOGIES INC.txt,15123,13487,1636,POSITIVE,5695,7989,-2294,NEGATIVE,3083,3274,2985,51,774,2097
1462 - TEXTRON INC.txt,15219,13582,1637,POSITIVE,5739,8047,-2308,NEGATIVE,3106,3296,3007,51,781,2112
1465 - THORATEC CORP.txt,15340,13678,1662,POSITIVE,5788,8097,-2309,NEGATIVE,3136,3319,3026,51,786,2128
1468 - TOLL BROTHERS INC.txt,15434,13738,1696,POSITIVE,5828,8117,-2289,NEGATIVE,3152,3332,3038,51,787,2138
147-Altra Industrial Motion Corp..txt,15517,13814,1703,POSITIVE,5858,8156,-2298,NEGATIVE,3166,3356,3056,51,790,2148
1471 - TORCHMARK CORP.txt,15602,13901,1701,POSITIVE,5886,8209,-2323,NEGATIVE,3188,3384,3085,51,793,2161
1473 - TOTAL SYSTEM SERVICES INC.txt,15718,13989,1729,POSITIVE,5927,8264,-2337,NEGATIVE,3215,3403,3107,51,800,2176
1474 - TRACTOR SUPPLY CO  DE.txt,15818,14079,1739,POSITIVE,5961,8302,-2341,NEGATIVE,3230,3424,3135,51,806,2192
1475 - TRAVELCENTERS OF AMERICA LLC.txt,15885,14134,1751,POSITIVE,5987,8325,-2338,NEGATIVE,3241,3434,3144,51,807,2200
1476 - TRAVELZOO INC.txt,15949,14189,1760,POSITIVE,6005,8349,-2344,NEGATIVE,3259,3449,3154,52,811,2210
"1478 - TRI Pointe Homes, Inc..txt",16022,14258,1764,POSITIVE,6037,8377,-2340,NEGATIVE,3274,3463,3170,52,814,2222
1480 - TRIMBLE NAVIGATION LTD  CA.txt,16091,14325,1766,POSITIVE,6058,8406,-2348,NEGATIVE,3293,3486,3185,52,817,2236
1482 - TRUSTMARK CORP.txt,16225,14461,1764,POSITIVE,6099,8505,-2406,NEGATIVE,3321,3530,3213,52,826,2254
1487 - TYLER TECHNOLOGIES INC.txt,16332,14540,1792,POSITIVE,6140,8549,-2409,NEGATIVE,3346,3552,3224,52,831,2267
1490 - Terreno Realty Corp.txt,16406,14597,1809,POSITIVE,6166,8568,-2402,NEGATIVE,3357,3569,3238,52,833,2275
1493 - Third Point Reinsurance Ltd..txt,16489,14665,1824,POSITIVE,6199,8597,-2398,NEGATIVE,3366,3582,3252,52,837,2281
1500 - Transocean Ltd..txt,16700,14859,1841,POSITIVE,6273,8740,-2467,NEGATIVE,3408,3655,3296,53,849,2303
"1504 - Triumph Bancorp, Inc..txt",16708,14868,1840,POSITIVE,6275,8743,-2468,NEGATIVE,3408,3656,3302,53,849,2303
"1505 - Tropicana Las Vegas Hotel & Casino, Inc..txt",16736,14898,1838,POSITIVE,6289,8749,-2460,NEGATIVE,3416,3658,3310,53,850,2311
1509 - UMPQUA HOLDINGS CORP.txt,16934,15078,1856,POSITIVE,6359,8873,-2514,NEGATIVE,3459,3717,3353,54,857,2340
151-American Electric Technologies Inc.txt,16980,15121,1859,POSITIVE,6376,8887,-2511,NEGATIVE,3468,3719,3365,54,858,2346
1516 - UNITED FIRE GROUP INC.txt,17075,15208,1867,POSITIVE,6420,8933,-2513,NEGATIVE,3486,3741,3383,55,863,2359
1520 - UNITED STATES LIME & MINERALS INC.txt,17141,15255,1886,POSITIVE,6445,8956,-2511,NEGATIVE,3496,3755,3391,55,865,2367
1521 - UNITED STATES STEEL CORP.txt,17272,15366,1906,POSITIVE,6503,9029,-2526,NEGATIVE,3522,3782,3420,55,872,2381
1525 - UNIVERSAL FOREST PRODUCTS INC.txt,17318,15429,1889,POSITIVE,6519,9055,-2536,NEGATIVE,3537,3789,3435,55,874,2391
1528 - URSTADT BIDDLE PROPERTIES INC.txt,17404,15501,1903,POSITIVE,6552,9089,-2537,NEGATIVE,3557,3800,3449,55,879,2400
1530 - US CONCRETE INC.txt,17508,15583,1925,POSITIVE,6591,9137,-2546,NEGATIVE,3572,3820,3461,55,882,2414
1531 - USANA HEALTH SCIENCES INC.txt,17589,15643,1946,POSITIVE,6621,9166,-2545,NEGATIVE,3584,3844,3469,55,886,2426
1532 - UTAH MEDICAL PRODUCTS INC.txt,17674,15700,1974,POSITIVE,6657,9193,-2536,NEGATIVE,3598,3856,3477,56,889,2441
1535 - Uni-Pixel.txt,17720,15728,1992,POSITIVE,6676,9200,-2524,NEGATIVE,3601,3860,3481,56,890,2444
"1537 - United Financial Bancorp, Inc..txt",17854,15821,2033,POSITIVE,6724,9247,-2523,NEGATIVE,3622,3883,3499,56,900,2460
1539 - V F CORP.txt,17956,15916,2040,POSITIVE,6764,9303,-2539,NEGATIVE,3649,3902,3526,56,906,2478
1549 - VCA INC.txt,18076,16030,2046,POSITIVE,6813,9395,-2582,NEGATIVE,3674,3941,3550,57,918,2492
1550 - VECTREN CORP.txt,18184,16128,2056,POSITIVE,6853,9462,-2609,NEGATIVE,3693,3962,3570,58,923,2503
"1566 - Vectrus, Inc..txt",18292,16220,2072,POSITIVE,6889,9516,-2627,NEGATIVE,3712,3983,3591,58,926,2517
1567 - Vericel Corp.txt,18353,16261,2092,POSITIVE,6907,9532,-2625,NEGATIVE,3721,3990,3594,58,927,2527
1569 - Viacom Inc..txt,18480,16362,2118,POSITIVE,6961,9596,-2635,NEGATIVE,3740,4015,3626,58,933,2543
1570 - Vulcan Materials CO.txt,18603,16471,2132,POSITIVE,7008,9650,-2642,NEGATIVE,3760,4038,3647,59,940,2555
1572 - W&T OFFSHORE INC.txt,18703,16556,2147,POSITIVE,7048,9697,-2649,NEGATIVE,3775,4064,3667,59,944,2569
1575 - WALT DISNEY CO.txt,18836,16666,2170,POSITIVE,7104,9758,-2654,NEGATIVE,3804,4085,3691,59,951,2586
1579 - WASTE MANAGEMENT INC.txt,18971,16776,2195,POSITIVE,7156,9836,-2680,NEGATIVE,3827,4120,3720,60,957,2604
1580 - WATTS WATER TECHNOLOGIES INC.txt,19084,16874,2210,POSITIVE,7194,9908,-2714,NEGATIVE,3852,4142,3747,60,961,2620
1587 - WEST BANCORPORATION INC.txt,19166,16951,2215,POSITIVE,7225,9950,-2725,NEGATIVE,3869,4159,3768,60,965,2637
1589 - WESTAMERICA BANCORPORATION.txt,19256,17030,2226,POSITIVE,7262,10001,-2739,NEGATIVE,3885,4187,3781,60,969,2648
1597 - WHIRLPOOL CORP  DE.txt,19376,17122,2254,POSITIVE,7317,10056,-2739,NEGATIVE,3902,4205,3803,60,974,2662
1598 - WILSON BANK HOLDING CO.txt,19442,17185,2257,POSITIVE,7342,10084,-2742,NEGATIVE,3909,4227,3814,60,981,2669
16-ABM INDUSTRIES INC  DE.txt,19569,17299,2270,POSITIVE,7390,10157,-2767,NEGATIVE,3928,4257,3840,60,987,2688
160-Avery Dennison Corp.txt,19706,17434,2272,POSITIVE,7443,10256,-2813,NEGATIVE,3955,4299,3869,61,994,2702
"1600 - WINDSTREAM HOLDINGS, INC..txt",19816,17549,2267,POSITIVE,7482,10316,-2834,NEGATIVE,3977,4323,3893,61,1000,2716
1601 - WINMARK CORP.txt,19865,17588,2277,POSITIVE,7497,10332,-2835,NEGATIVE,3985,4330,3902,61,1001,2722
1605 - WOLVERINE WORLD WIDE INC  DE.txt,19962,17675,2287,POSITIVE,7537,10384,-2847,NEGATIVE,4011,4343,3931,62,1005,2740
1606 - WORLD WRESTLING ENTERTAINMENTINC.txt,20071,17771,2300,POSITIVE,7574,10438,-2864,NEGATIVE,4034,4367,3957,62,1011,2761
"1609 - Walter Energy, Inc..txt",20187,17881,2306,POSITIVE,7619,10513,-2894,NEGATIVE,4059,4386,3984,62,1016,2778
"1611 - Waterstone Financial, Inc..txt",20242,17926,2316,POSITIVE,7637,10526,-2889,NEGATIVE,4071,4395,3991,62,1018,2786
1616 - Whitestone REIT.txt,20332,18005,2327,POSITIVE,7667,10565,-2898,NEGATIVE,4085,4408,4001,62,1022,2802
1617 - XL GROUP PLC.txt,20467,18101,2366,POSITIVE,7742,10623,-2881,NEGATIVE,4104,4431,4024,62,1028,2812
1627 - ZIMMER HOLDINGS INC.txt,20580,18205,2375,POSITIVE,7791,10677,-2886,NEGATIVE,4123,4458,4046,63,1036,2827
167-BALL CORP.txt,20581,18206,2375,POSITIVE,7792,10678,-2886,NEGATIVE,4123,4458,4046,63,1036,2827
169-BANK MUTUAL CORP.txt,20686,18300,2386,POSITIVE,7828,10724,-2896,NEGATIVE,4150,4482,4068,63,1043,2847
170-BANK OF AMERICA CORP  DE.txt,20789,18387,2402,POSITIVE,7873,10776,-2903,NEGATIVE,4171,4512,4084,63,1047,2855
171-BANK OF HAWAII CORP.txt,20906,18497,2409,POSITIVE,7917,10834,-2917,NEGATIVE,4187,4530,4107,63,1051,2871
18-ACCURIDE CORP.txt,20979,18568,2411,POSITIVE,7947,10873,-2926,NEGATIVE,4203,4543,4120,63,1052,2883
182-BCB BANCORP INC.txt,21045,18628,2417,POSITIVE,7968,10907,-2939,NEGATIVE,4219,4555,4136,63,1053,2898
183-BEACON ROOFING SUPPLY INC.txt,21135,18698,2437,POSITIVE,7998,10932,-2934,NEGATIVE,4234,4573,4151,63,1057,2908
184-BEMIS CO INC.txt,21225,18774,2451,POSITIVE,8028,10965,-2937,NEGATIVE,4250,4587,4171,64,1060,2924
185-BERKSHIRE HATHAWAY INC.txt,21238,18791,2447,POSITIVE,8033,10974,-2941,NEGATIVE,4253,4587,4173,64,1060,2930
192-BLACK HILLS CORP  SD.txt,21340,18874,2466,POSITIVE,8073,11019,-2946,NEGATIVE,4268,4608,4188,64,1067,2942
206-BOSTON PRIVATE FINANCIAL HOLDINGS INC.txt,21449,18959,2490,POSITIVE,8123,11066,-2943,NEGATIVE,4288,4628,4210,64,1074,2953
210-BRIGHT HORIZONS FAMILY SOLUTIONS INC..txt,21526,19021,2505,POSITIVE,8143,11089,-2946,NEGATIVE,4298,4640,4222,64,1078,2963
211-BRINKS CO.txt,21621,19116,2505,POSITIVE,8182,11148,-2966,NEGATIVE,4323,4661,4236,64,1087,2981
212-BRISTOL MYERS SQUIBB CO.txt,21773,19230,2543,POSITIVE,8247,11224,-2977,NEGATIVE,4354,4693,4258,64,1099,3000
213-BROADCOM CORP.txt,21909,19333,2576,POSITIVE,8298,11303,-3005,NEGATIVE,4388,4718,4288,65,1108,3024
221-BRT REALTY TRUST.txt,21993,19407,2586,POSITIVE,8324,11347,-3023,NEGATIVE,4406,4734,4303,65,1114,3038
223-BRYN MAWR BANK CORP.txt,22113,19502,2611,POSITIVE,8367,11389,-3022,NEGATIVE,4428,4763,4317,66,1123,3051
237-Bourbon Brothers Holding Corp.txt,22140,19533,2607,POSITIVE,8380,11394,-3014,NEGATIVE,4435,4768,4322,66,1123,3055
"238-Bravo Brio Restaurant Group, Inc..txt",22143,19543,2600,POSITIVE,8381,11401,-3020,NEGATIVE,4435,4769,4323,66,1123,3056
"24-ADAMS RESOURCES _ ENERGY, INC..txt",22187,19596,2591,POSITIVE,8391,11425,-3034,NEGATIVE,4447,4785,4336,66,1125,3064
"244-C1 Financial, Inc..txt",22208,19624,2584,POSITIVE,8396,11438,-3042,NEGATIVE,4448,4789,4348,67,1125,3067
245-CABOT CORP.txt,22336,19719,2617,POSITIVE,8450,11498,-3048,NEGATIVE,4470,4814,4367,68,1131,3084
246-CABOT MICROELECTRONICS CORP.txt,22457,19815,2642,POSITIVE,8491,11556,-3065,NEGATIVE,4498,4846,4384,68,1134,3105
251-CALPINE CORP.txt,22568,19908,2660,POSITIVE,8534,11613,-3079,NEGATIVE,4524,4869,4407,68,1139,3118
253-CAMDEN NATIONAL CORP.txt,22605,19931,2674,POSITIVE,8542,11625,-3083,NEGATIVE,4529,4872,4409,68,1141,3122
258-CAPITAL ONE FINANCIAL CORP.txt,22737,20032,2705,POSITIVE,8593,11694,-3101,NEGATIVE,4553,4901,4433,69,1148,3139
26-ADOBE SYSTEMS INC.txt,22867,20141,2726,POSITIVE,8645,11756,-3111,NEGATIVE,4584,4928,4456,69,1156,3159
262-CARLISLE COMPANIES INC.txt,22958,20229,2729,POSITIVE,8686,11804,-3118,NEGATIVE,4605,4948,4480,69,1163,3172
268-CASS INFORMATION SYSTEMS INC.txt,23049,20307,2742,POSITIVE,8723,11843,-3120,NEGATIVE,4615,4969,4491,69,1168,3181
27-ADT Corp.txt,23158,20404,2754,POSITIVE,8768,11893,-3125,NEGATIVE,4638,4984,4513,70,1177,3198
270-CBL _ ASSOCIATES PROPERTIES INC.txt,23274,20487,2787,POSITIVE,8816,11947,-3131,NEGATIVE,4653,5012,4531,71,1181,3211
"272-CEDAR REALTY TRUST, INC..txt",23377,20561,2816,POSITIVE,8852,11990,-3138,NEGATIVE,4668,5027,4548,71,1185,3222
273-CENTENE CORP.txt,23478,20659,2819,POSITIVE,8885,12044,-3159,NEGATIVE,4686,5056,4577,71,1190,3239
276-CENTRAL PACIFIC FINANCIAL CORP.txt,23547,20705,2842,POSITIVE,8913,12067,-3154,NEGATIVE,4700,5066,4591,71,1190,3248
279-CEPHEID.txt,23651,20827,2824,POSITIVE,8949,12140,-3191,NEGATIVE,4727,5113,4613,71,1195,3263
28-ADVANCED ENERGY INDUSTRIES INC.txt,23741,20898,2843,POSITIVE,8981,12169,-3188,NEGATIVE,4744,5132,4625,71,1198,3274
284-CHARLES RIVER LABORATORIES INTERNATIONAL INC.txt,23884,21009,2875,POSITIVE,9043,12245,-3202,NEGATIVE,4776,5153,4657,72,1207,3291
"287-CHARTER COMMUNICATIONS, INC.  MO .txt",23974,21096,2878,POSITIVE,9080,12297,-3217,NEGATIVE,4807,5170,4671,72,1215,3306
288-CHEMICAL FINANCIAL CORP.txt,24004,21129,2875,POSITIVE,9090,12303,-3213,NEGATIVE,4813,5172,4676,72,1216,3312
289-CHEMUNG FINANCIAL CORP.txt,24071,21196,2875,POSITIVE,9116,12332,-3216,NEGATIVE,4829,5187,4691,72,1220,3325
291-CHICAGO BRIDGE _ IRON CO N V.txt,24156,21283,2873,POSITIVE,9147,12373,-3226,NEGATIVE,4846,5206,4713,73,1224,3341
"294-CHINA JO-JO DRUGSTORES, INC..txt",24189,21302,2887,POSITIVE,9159,12384,-3225,NEGATIVE,4848,5206,4716,73,1224,3343
295-CHIPOTLE MEXICAN GRILL INC.txt,24220,21333,2887,POSITIVE,9170,12400,-3230,NEGATIVE,4851,5207,4718,73,1225,3350
298-CHUBB CORP.txt,24340,21445,2895,POSITIVE,9219,12463,-3244,NEGATIVE,4875,5229,4742,74,1231,3365
300-CHURCHILL DOWNS INC.txt,24424,21515,2909,POSITIVE,9253,12494,-3241,NEGATIVE,4887,5250,4754,74,1234,3374
303-CINCINNATI BELL INC.txt,24540,21607,2933,POSITIVE,9293,12557,-3264,NEGATIVE,4916,5280,4775,74,1240,3390
310-CITIZENS FINANCIAL SERVICES INC.txt,24625,21667,2958,POSITIVE,9326,12581,-3255,NEGATIVE,4926,5295,4785,74,1245,3399
312-CITY HOLDING CO.txt,24719,21753,2966,POSITIVE,9358,12626,-3268,NEGATIVE,4940,5316,4805,74,1249,3414
317-CLEVELAND BIOLABS INC.txt,24816,21868,2948,POSITIVE,9388,12693,-3305,NEGATIVE,4964,5352,4821,74,1262,3430
318-CLOUD PEAK ENERGY INC..txt,24926,21986,2940,POSITIVE,9423,12776,-3353,NEGATIVE,4984,5384,4851,74,1273,3446
319-CMS ENERGY CORP.txt,25025,22073,2952,POSITIVE,9454,12823,-3369,NEGATIVE,5003,5407,4874,74,1277,3460
320-CNA FINANCIAL CORP.txt,25101,22134,2967,POSITIVE,9484,12853,-3369,NEGATIVE,5016,5422,4893,74,1282,3472
321-CNB FINANCIAL CORP PA.txt,25181,22209,2972,POSITIVE,9508,12894,-3386,NEGATIVE,5032,5438,4905,74,1290,3487
323-COBIZ FINANCIAL INC.txt,25280,22306,2974,POSITIVE,9551,12944,-3393,NEGATIVE,5052,5456,4933,75,1297,3501
324-COCA COLA BOTTLING CO CONSOLIDATED  DE.txt,25368,22374,2994,POSITIVE,9579,12977,-3398,NEGATIVE,5067,5468,4950,75,1303,3513
327-COFFEE HOLDING CO INC.txt,25377,22385,2992,POSITIVE,9581,12980,-3399,NEGATIVE,5067,5471,4951,75,1303,3513
"328-COGENT COMMUNICATIONS HOLDINGS, INC..txt",25452,22447,3005,POSITIVE,9611,12997,-3386,NEGATIVE,5077,5480,4960,75,1304,3525
329-COGNEX CORP.txt,25521,22500,3021,POSITIVE,9634,13026,-3392,NEGATIVE,5088,5489,4966,76,1308,3538
33-AECOM.txt,25589,22545,3044,POSITIVE,9670,13043,-3373,NEGATIVE,5097,5496,4976,76,1310,3544
330-COHEN _ STEERS INC.txt,25667,22630,3037,POSITIVE,9695,13093,-3398,NEGATIVE,5114,5515,4996,78,1312,3557
335-COHERENT INC.txt,25748,22715,3033,POSITIVE,9718,13136,-3418,NEGATIVE,5139,5544,5019,78,1315,3570
336-COLGATE PALMOLIVE CO.txt,25852,22795,3057,POSITIVE,9754,13185,-3431,NEGATIVE,5159,5563,5036,79,1318,3588
34-AEP INDUSTRIES INC.txt,25950,22891,3059,POSITIVE,9783,13242,-3459,NEGATIVE,5181,5586,5060,79,1325,3601
342.COMERICA INC  NEW.txt,26095,23019,3076,POSITIVE,9838,13338,-3500,NEGATIVE,5211,5623,5087,79,1336,3623
346-COMPASS MINERALS INTERNATIONAL INC.txt,26207,23117,3090,POSITIVE,9884,13394,-3510,NEGATIVE,5234,5650,5113,80,1338,3638
"346-PASSUR Aerospace, Inc..txt",26229,23136,3093,POSITIVE,9894,13405,-3511,NEGATIVE,5236,5651,5113,80,1340,3641
348-CONNECTICUT WATER SERVICE INC   CT.txt,26275,23172,3103,POSITIVE,9909,13415,-3506,NEGATIVE,5243,5657,5117,80,1342,3645
350-CONSOL Energy Inc.txt,26375,23270,3105,POSITIVE,9949,13473,-3524,NEGATIVE,5263,5690,5140,80,1347,3656
354-COOPER COMPANIES INC.txt,26472,23344,3128,POSITIVE,9986,13512,-3526,NEGATIVE,5284,5709,5157,80,1353,3672
356-CORE LABORATORIES N V.txt,26583,23433,3150,POSITIVE,10035,13558,-3523,NEGATIVE,5303,5730,5178,81,1358,3686
359-CORPORATE OFFICE PROPERTIES TRUST.txt,26700,23520,3180,POSITIVE,10086,13604,-3518,NEGATIVE,5324,5761,5213,81,1362,3703
361-COTT CORP  CN.txt,26826,23617,3209,POSITIVE,10127,13669,-3542,NEGATIVE,5353,5791,5233,81,1366,3721
364-COVANTA HOLDING CORP.txt,26984,23744,3240,POSITIVE,10194,13758,-3564,NEGATIVE,5383,5832,5258,83,1372,3735
365-CPS TECHNOLOGIES CORP DE.txt,27051,23807,3244,POSITIVE,10224,13791,-3567,NEGATIVE,5395,5855,5276,83,1374,3746
369-CROWN HOLDINGS INC.txt,27142,23893,3249,POSITIVE,10262,13835,-3573,NEGATIVE,5414,5879,5293,83,1382,3759
37-AES CORP.txt,27190,23949,3241,POSITIVE,10278,13862,-3584,NEGATIVE,5424,5885,5304,83,1382,3767
371-CSX CORP.txt,27328,24102,3226,POSITIVE,10338,13975,-3637,NEGATIVE,5460,5918,5341,84,1390,3786
"374-CULLEN FROST BANKERS, INC..txt",27455,24216,3239,POSITIVE,10391,14040,-3649,NEGATIVE,5485,5946,5360,85,1396,3802
375-CUMMINS INC.txt,27579,24309,3270,POSITIVE,10440,14096,-3656,NEGATIVE,5507,5971,5382,85,1402,3818
38-AFFYMETRIX INC.txt,27679,24399,3280,POSITIVE,10489,14148,-3659,NEGATIVE,5525,5987,5399,85,1408,3829
380-CYTEC INDUSTRIES INC DE.txt,27805,24511,3294,POSITIVE,10539,14219,-3680,NEGATIVE,5556,6012,5427,85,1414,3843
383-Caesars Acquisition Co.txt,27815,24539,3276,POSITIVE,10541,14231,-3690,NEGATIVE,5560,6013,5435,85,1414,3844
389-Catamaran Corp.txt,27930,24614,3316,POSITIVE,10588,14266,-3678,NEGATIVE,5580,6034,5458,85,1420,3858
390-Celanese Corp.txt,28056,24722,3334,POSITIVE,10641,14324,-3683,NEGATIVE,5593,6056,5481,85,1424,3873
"391-CenterState Banks, Inc..txt",28139,24810,3329,POSITIVE,10663,14378,-3715,NEGATIVE,5605,6075,5509,85,1431,3884
"396-Childrens Place, Inc..txt",28240,24904,3336,POSITIVE,10709,14428,-3719,NEGATIVE,5619,6087,5525,86,1436,3900
"400-Civitas Solutions, Inc..txt",28316,24993,3323,POSITIVE,10740,14475,-3735,NEGATIVE,5635,6112,5539,87,1440,3911
421.txt,28402,25062,3340,POSITIVE,10768,14509,-3741,NEGATIVE,5658,6127,5554,87,1446,3925
423.txt,28497,25143,3354,POSITIVE,10793,14554,-3761,NEGATIVE,5672,6151,5578,87,1452,3934
43-AGILENT TECHNOLOGIES INC.txt,28602,25247,3355,POSITIVE,10833,14618,-3785,NEGATIVE,5697,6169,5604,87,1459,3947
437.txt,28668,25297,3371,POSITIVE,10854,14651,-3797,NEGATIVE,5702,6188,5616,87,1460,3955
438.txt,28722,25338,3384,POSITIVE,10879,14663,-3784,NEGATIVE,5706,6192,5620,87,1460,3962
44-AGL RESOURCES INC.txt,28840,25425,3415,POSITIVE,10920,14715,-3795,NEGATIVE,5732,6219,5649,87,1465,3973
440.txt,28959,25515,3444,POSITIVE,10968,14760,-3792,NEGATIVE,5749,6242,5678,87,1471,3990
459.txt,29079,25632,3447,POSITIVE,11012,14828,-3816,NEGATIVE,5771,6268,5710,87,1476,4008
464.txt,29159,25714,3445,POSITIVE,11032,14870,-3838,NEGATIVE,5786,6283,5727,87,1482,4018
473.txt,29304,25827,3477,POSITIVE,11096,14948,-3852,NEGATIVE,5812,6310,5754,88,1486,4036
474.txt,29410,25911,3499,POSITIVE,11128,14991,-3863,NEGATIVE,5830,6340,5779,88,1493,4047
475.txt,29506,26011,3495,POSITIVE,11163,15055,-3892,NEGATIVE,5847,6366,5794,89,1498,4057
476.txt,29528,26043,3485,POSITIVE,11165,15064,-3899,NEGATIVE,5853,6367,5801,89,1499,4062
478.txt,29624,26136,3488,POSITIVE,11198,15114,-3916,NEGATIVE,5885,6390,5821,89,1506,4080
479.txt,29736,26216,3520,POSITIVE,11254,15158,-3904,NEGATIVE,5902,6413,5837,89,1509,4095
481.txt,29818,26294,3524,POSITIVE,11275,15212,-3937,NEGATIVE,5917,6445,5866,89,1513,4108
482.txt,29944,26399,3545,POSITIVE,11325,15277,-3952,NEGATIVE,5947,6470,5885,89,1517,4124
484.txt,30042,26486,3556,POSITIVE,11362,15321,-3959,NEGATIVE,5963,6487,5899,89,1520,4138
485.txt,30178,26588,3590,POSITIVE,11411,15382,-3971,NEGATIVE,5988,6511,5917,90,1526,4152
487.txt,30299,26676,3623,POSITIVE,11444,15431,-3987,NEGATIVE,6007,6539,5944,90,1534,4165
488.txt,30392,26755,3637,POSITIVE,11484,15470,-3986,NEGATIVE,6026,6549,5961,90,1538,4177
490.txt,30512,26853,3659,POSITIVE,11533,15527,-3994,NEGATIVE,6051,6575,5990,91,1540,4190
492.txt,30531,26870,3661,POSITIVE,11537,15535,-3998,NEGATIVE,6055,6587,5997,91,1540,4195
496.txt,30583,26898,3685,POSITIVE,11560,15547,-3987,NEGATIVE,6058,6588,5998,91,1542,4198
497.txt,30683,26995,3688,POSITIVE,11593,15614,-4021,NEGATIVE,6089,6619,6022,92,1547,4212
499.txt,30781,27108,3673,POSITIVE,11622,15694,-4072,NEGATIVE,6111,6642,6053,93,1556,4224
"5-A-Mark Precious Metals, Inc..txt",30871,27197,3674,POSITIVE,11659,15754,-4095,NEGATIVE,6132,6676,6071,93,1560,4237
50-ALICO INC.txt,30949,27248,3701,POSITIVE,11685,15775,-4090,NEGATIVE,6144,6686,6085,93,1563,4249
501.txt,31057,27346,3711,POSITIVE,11726,15831,-4105,NEGATIVE,6178,6710,6103,94,1566,4264
502.txt,31181,27443,3738,POSITIVE,11785,15881,-4096,NEGATIVE,6194,6738,6121,94,1574,4280
513.txt,31391,27635,3756,POSITIVE,11856,16032,-4176,NEGATIVE,6233,6801,6154,97,1584,4306
517.txt,31478,27709,3769,POSITIVE,11890,16076,-4186,NEGATIVE,6257,6811,6167,97,1586,4319
519.txt,31550,27778,3772,POSITIVE,11912,16121,-4209,NEGATIVE,6270,6834,6184,98,1593,4331
52-ALLEGHENY TECHNOLOGIES INC.txt,31687,27905,3782,POSITIVE,11974,16185,-4211,NEGATIVE,6297,6858,6208,99,1601,4349
520.txt,31787,27993,3794,POSITIVE,12012,16248,-4236,NEGATIVE,6312,6881,6225,99,1602,4362
521.txt,31904,28077,3827,POSITIVE,12052,16294,-4242,NEGATIVE,6337,6902,6242,99,1605,4378
523.txt,31994,28135,3859,POSITIVE,12087,16325,-4238,NEGATIVE,6347,6918,6251,99,1609,4391
524.txt,32081,28222,3859,POSITIVE,12116,16380,-4264,NEGATIVE,6366,6947,6272,99,1612,4403
529.txt,32165,28323,3842,POSITIVE,12142,16437,-4295,NEGATIVE,6386,6974,6294,99,1622,4418
53-ALLETE INC.txt,32264,28406,3858,POSITIVE,12180,16481,-4301,NEGATIVE,6404,6985,6308,100,1628,4429
538.txt,32350,28498,3852,POSITIVE,12209,16530,-4321,NEGATIVE,6419,7008,6329,101,1639,4439
548.txt,32463,28603,3860,POSITIVE,12250,16606,-4356,NEGATIVE,6435,7051,6354,102,1644,4451
550.txt,32598,28713,3885,POSITIVE,12301,16678,-4377,NEGATIVE,6460,7073,6376,102,1647,4471
563.txt,32670,28769,3901,POSITIVE,12318,16702,-4384,NEGATIVE,6468,7085,6387,102,1652,4481
565.txt,32802,28881,3921,POSITIVE,12371,16761,-4390,NEGATIVE,6485,7108,6405,104,1656,4495
573.txt,32860,28942,3918,POSITIVE,12395,16793,-4398,NEGATIVE,6496,7128,6430,104,1659,4506
579.txt,32923,29011,3912,POSITIVE,12411,16829,-4418,NEGATIVE,6506,7144,6443,105,1660,4517
580.txt,33005,29097,3908,POSITIVE,12444,16880,-4436,NEGATIVE,6526,7166,6464,105,1666,4528
586.txt,33023,29111,3912,POSITIVE,12450,16884,-4434,NEGATIVE,6528,7167,6464,105,1666,4528
600.txt,33117,29191,3926,POSITIVE,12483,16915,-4432,NEGATIVE,6549,7184,6484,105,1671,4541
603.txt,33170,29246,3924,POSITIVE,12505,16940,-4435,NEGATIVE,6556,7192,6495,106,1675,4546
605.txt,33258,29340,3918,POSITIVE,12539,17002,-4463,NEGATIVE,6567,7218,6512,107,1680,4556
608.txt,33313,29392,3921,POSITIVE,12555,17016,-4461,NEGATIVE,6579,7227,6524,107,1684,4564
610.txt,33397,29474,3923,POSITIVE,12584,17066,-4482,NEGATIVE,6599,7238,6540,107,1691,4575
611.txt,33519,29574,3945,POSITIVE,12639,17130,-4491,NEGATIVE,6617,7267,6560,108,1696,4590
628.txt,33581,29631,3950,POSITIVE,12663,17150,-4487,NEGATIVE,6631,7276,6573,108,1699,4598
632.txt,33687,29720,3967,POSITIVE,12697,17200,-4503,NEGATIVE,6653,7291,6594,108,1702,4612
634.txt,33781,29811,3970,POSITIVE,12733,17272,-4539,NEGATIVE,6679,7313,6615,108,1711,4628
636.txt,33931,29908,4023,POSITIVE,12800,17332,-4532,NEGATIVE,6706,7337,6633,108,1716,4647
641.txt,34036,30002,4034,POSITIVE,12840,17384,-4544,NEGATIVE,6723,7351,6652,108,1722,4662
642.txt,34105,30053,4052,POSITIVE,12862,17411,-4549,NEGATIVE,6741,7366,6661,108,1726,4677
648.txt,34217,30144,4073,POSITIVE,12908,17466,-4558,NEGATIVE,6769,7397,6684,109,1729,4694
654.txt,34229,30162,4067,POSITIVE,12909,17471,-4562,NEGATIVE,6773,7402,6687,109,1730,4696
657.txt,34320,30246,4074,POSITIVE,12945,17510,-4565,NEGATIVE,6789,7417,6702,109,1733,4706
667.txt,34418,30326,4092,POSITIVE,12983,17548,-4565,NEGATIVE,6805,7434,6721,109,1735,4721
671.txt,34427,30336,4091,POSITIVE,12984,17551,-4567,NEGATIVE,6805,7435,6721,109,1735,4722
684.txt,34533,30430,4103,POSITIVE,13016,17602,-4586,NEGATIVE,6824,7452,6737,109,1742,4737
687.txt,34617,30527,4090,POSITIVE,13045,17643,-4598,NEGATIVE,6840,7465,6756,109,1749,4748
"69-AMC ENTERTAINMENT HOLDINGS, INC..txt",34711,30635,4076,POSITIVE,13072,17711,-4639,NEGATIVE,6863,7502,6785,113,1757,4764
690.txt,34833,30736,4097,POSITIVE,13124,17770,-4646,NEGATIVE,6888,7524,6814,114,1762,4780
694.txt,34926,30811,4115,POSITIVE,13154,17807,-4653,NEGATIVE,6901,7546,6828,116,1766,4791
697.txt,35056,30931,4125,POSITIVE,13210,17883,-4673,NEGATIVE,6925,7570,6846,118,1776,4808
699.txt,35068,30945,4123,POSITIVE,13213,17886,-4673,NEGATIVE,6930,7570,6849,118,1776,4810
7-ABBOTT LABORATORIES.txt,35153,31029,4124,POSITIVE,13237,17918,-4681,NEGATIVE,6945,7586,6871,119,1778,4820
70-AMEREN CORP.txt,35239,31113,4126,POSITIVE,13266,17966,-4700,NEGATIVE,6966,7605,6886,119,1783,4837
701.txt,35309,31173,4136,POSITIVE,13290,17998,-4708,NEGATIVE,6983,7617,6898,120,1784,4848
703.txt,35378,31212,4166,POSITIVE,13316,18012,-4696,NEGATIVE,6994,7630,6904,120,1786,4858
704.txt,35477,31301,4176,POSITIVE,13348,18070,-4722,NEGATIVE,7025,7653,6931,120,1790,4873
705.txt,35590,31419,4171,POSITIVE,13387,18142,-4755,NEGATIVE,7050,7683,6959,121,1796,4891
708.txt,35681,31504,4177,POSITIVE,13418,18190,-4772,NEGATIVE,7071,7711,6983,121,1801,4904
709.txt,35795,31609,4186,POSITIVE,13456,18245,-4789,NEGATIVE,7094,7739,7009,121,1806,4919
71-AMERICAN AXLE _ MANUFACTURING HOLDINGS INC.txt,35891,31680,4211,POSITIVE,13499,18288,-4789,NEGATIVE,7109,7757,7034,121,1810,4930
710.txt,36021,31807,4214,POSITIVE,13546,18373,-4827,NEGATIVE,7143,7790,7055,121,1820,4948
713.txt,36097,31874,4223,POSITIVE,13573,18405,-4832,NEGATIVE,7158,7797,7069,121,1825,4959
718.txt,36165,31928,4237,POSITIVE,13589,18429,-4840,NEGATIVE,7173,7812,7086,121,1826,4971
724.txt,36253,32005,4248,POSITIVE,13623,18473,-4850,NEGATIVE,7193,7837,7101,121,1830,4987
727.txt,36296,32046,4250,POSITIVE,13637,18494,-4857,NEGATIVE,7202,7845,7109,121,1832,4996
729.txt,36404,32144,4260,POSITIVE,13675,18549,-4874,NEGATIVE,7217,7868,7126,122,1835,5010
734.txt,36477,32219,4258,POSITIVE,13701,18587,-4886,NEGATIVE,7232,7881,7146,122,1837,5022
735.txt,36564,32294,4270,POSITIVE,13727,18624,-4897,NEGATIVE,7247,7902,7160,122,1842,5033
736.txt,36685,32409,4276,POSITIVE,13769,18694,-4925,NEGATIVE,7285,7944,7180,123,1846,5048
738.txt,36687,32419,4268,POSITIVE,13771,18696,-4925,NEGATIVE,7285,7944,7180,123,1846,5048
74-AMERICAN CAMPUS COMMUNITIES INC.txt,36788,32483,4305,POSITIVE,13812,18738,-4926,NEGATIVE,7296,7956,7188,123,1852,5059
744.txt,36797,32499,4298,POSITIVE,13818,18747,-4929,NEGATIVE,7300,7957,7190,123,1852,5061
745.txt,36902,32584,4318,POSITIVE,13861,18799,-4938,NEGATIVE,7318,7972,7210,123,1860,5077
746.txt,37028,32694,4334,POSITIVE,13914,18864,-4950,NEGATIVE,7337,8003,7234,123,1868,5093
749.txt,37120,32770,4350,POSITIVE,13949,18907,-4958,NEGATIVE,7354,8024,7254,123,1871,5108
"75-AMERICAN CAPITAL, LTD.txt",37230,32880,4350,POSITIVE,13987,18972,-4985,NEGATIVE,7371,8055,7286,123,1875,5126
751.txt,37332,32975,4357,POSITIVE,14025,19021,-4996,NEGATIVE,7391,8073,7299,123,1879,5141
752.txt,37431,33062,4369,POSITIVE,14056,19081,-5025,NEGATIVE,7406,8097,7321,123,1884,5155
753.txt,37535,33148,4387,POSITIVE,14090,19138,-5048,NEGATIVE,7427,8118,7344,124,1889,5168
755.txt,37612,33208,4404,POSITIVE,14122,19171,-5049,NEGATIVE,7441,8127,7356,124,1892,5176
759.txt,37706,33298,4408,POSITIVE,14152,19213,-5061,NEGATIVE,7462,8154,7370,125,1896,5195
76-AMERICAN ELECTRIC POWER CO INC.txt,37798,33383,4415,POSITIVE,14187,19245,-5058,NEGATIVE,7479,8167,7392,127,1898,5211
761.txt,37929,33498,4431,POSITIVE,14235,19310,-5075,NEGATIVE,7504,8205,7423,128,1906,5227
767.txt,38040,33585,4455,POSITIVE,14275,19361,-5086,NEGATIVE,7528,8226,7436,128,1911,5240
770.txt,38090,33635,4455,POSITIVE,14289,19390,-5101,NEGATIVE,7538,8236,7444,128,1913,5248
771.txt,38296,33780,4516,POSITIVE,14378,19484,-5106,NEGATIVE,7569,8262,7469,128,1924,5267
772.txt,38440,33897,4543,POSITIVE,14441,19558,-5117,NEGATIVE,7591,8297,7494,128,1931,5285
773.txt,38482,33948,4534,POSITIVE,14451,19578,-5127,NEGATIVE,7602,8304,7504,128,1933,5291
774.txt,38611,34050,4561,POSITIVE,14504,19638,-5134,NEGATIVE,7627,8325,7532,128,1944,5309
781.txt,38711,34128,4583,POSITIVE,14538,19693,-5155,NEGATIVE,7645,8352,7555,128,1951,5321
783.txt,38811,34206,4605,POSITIVE,14572,19748,-5176,NEGATIVE,7663,8379,7578,128,1958,5333
784.txt,38909,34309,4600,POSITIVE,14616,19810,-5194,NEGATIVE,7688,8409,7597,128,1961,5351
786.txt,38911,34314,4597,POSITIVE,14618,19813,-5195,NEGATIVE,7688,8409,7597,128,1962,5351
788.txt,38999,34395,4604,POSITIVE,14648,19847,-5199,NEGATIVE,7708,8426,7619,129,1966,5366
791.txt,39140,34521,4619,POSITIVE,14704,19942,-5238,NEGATIVE,7740,8460,7660,129,1973,5387
794.txt,39239,34618,4621,POSITIVE,14731,19997,-5266,NEGATIVE,7765,8490,7682,129,1980,5401
806.txt,39340,34700,4640,POSITIVE,14772,20040,-5268,NEGATIVE,7784,8504,7699,129,1986,5412
808.txt,39431,34792,4639,POSITIVE,14800,20093,-5293,NEGATIVE,7801,8530,7721,129,1992,5425
813.txt,39511,34883,4628,POSITIVE,14831,20153,-5322,NEGATIVE,7811,8561,7744,130,1995,5435
815.txt,39601,34954,4647,POSITIVE,14865,20194,-5329,NEGATIVE,7828,8573,7751,130,1997,5450
819.txt,39702,35046,4656,POSITIVE,14896,20242,-5346,NEGATIVE,7845,8592,7769,131,2003,5463
820.txt,39816,35139,4677,POSITIVE,14951,20302,-5351,NEGATIVE,7872,8620,7787,131,2011,5476
822.txt,39840,35172,4668,POSITIVE,14960,20315,-5355,NEGATIVE,7880,8622,7790,131,2012,5482
824.txt,39849,35185,4664,POSITIVE,14961,20321,-5360,NEGATIVE,7882,8628,7794,131,2013,5483
827.txt,39917,35236,4681,POSITIVE,14987,20338,-5351,NEGATIVE,7891,8638,7800,131,2015,5491
829.txt,40046,35334,4712,POSITIVE,15046,20390,-5344,NEGATIVE,7910,8667,7823,132,2020,5507
83-AMERISERV FINANCIAL INC  PA.txt,40062,35359,4703,POSITIVE,15049,20406,-5357,NEGATIVE,7916,8669,7824,132,2020,5510
836.txt,40144,35421,4723,POSITIVE,15069,20433,-5364,NEGATIVE,7932,8682,7840,132,2024,5522
84-AMERISOURCEBERGEN CORP.txt,40244,35511,4733,POSITIVE,15112,20490,-5378,NEGATIVE,7946,8698,7856,132,2026,5536
840.txt,40270,35540,4730,POSITIVE,15120,20503,-5383,NEGATIVE,7956,8702,7865,132,2027,5541
844.txt,40332,35588,4744,POSITIVE,15138,20524,-5386,NEGATIVE,7968,8719,7874,132,2029,5551
846.txt,40456,35695,4761,POSITIVE,15188,20592,-5404,NEGATIVE,7995,8744,7902,132,2036,5568
850.txt,40551,35763,4788,POSITIVE,15225,20630,-5405,NEGATIVE,8010,8761,7919,133,2040,5583
855-LCNV CORP.txt,40624,35820,4804,POSITIVE,15252,20650,-5398,NEGATIVE,8020,8781,7926,134,2043,5594
859.txt,40736,35920,4816,POSITIVE,15304,20705,-5401,NEGATIVE,8041,8806,7942,134,2051,5610
864.txt,40804,35990,4814,POSITIVE,15325,20742,-5417,NEGATIVE,8058,8824,7961,134,2053,5621
866.txt,40915,36089,4826,POSITIVE,15377,20798,-5421,NEGATIVE,8089,8849,7981,135,2059,5636
867.txt,41033,36196,4837,POSITIVE,15424,20860,-5436,NEGATIVE,8118,8872,8000,135,2063,5655
"869-KINDER MORGAN, INC..txt",41109,36270,4839,POSITIVE,15449,20901,-5452,NEGATIVE,8136,8897,8012,135,2065,5669
870-KIRBY CORP.txt,41187,36341,4846,POSITIVE,15474,20932,-5458,NEGATIVE,8154,8916,8029,135,2068,5684
874-KONA GRILL INC.txt,41239,36393,4846,POSITIVE,15486,20953,-5467,NEGATIVE,8162,8924,8038,135,2070,5692
"876-Keysight Technologies, Inc..txt",41332,36488,4844,POSITIVE,15515,21008,-5493,NEGATIVE,8185,8938,8064,135,2077,5706
88-AMN HEALTHCARE SERVICES INC.txt,41440,36563,4877,POSITIVE,15559,21042,-5483,NEGATIVE,8209,8956,8079,135,2080,5720
887-LEAR CORP.txt,41549,36664,4885,POSITIVE,15602,21101,-5499,NEGATIVE,8231,8976,8102,136,2082,5734
"889-LEE ENTERPRISES, INC.txt",41631,36732,4899,POSITIVE,15630,21128,-5498,NEGATIVE,8241,8989,8110,136,2084,5744
890-LEGACY RESERVES LP.txt,41724,36806,4918,POSITIVE,15663,21185,-5522,NEGATIVE,8258,9013,8127,137,2088,5753
"893-LEXICON PHARMACEUTICALS, INC..txt",41787,36878,4909,POSITIVE,15689,21226,-5537,NEGATIVE,8273,9025,8140,137,2092,5760
896-LIBBEY INC.txt,41910,36999,4911,POSITIVE,15738,21310,-5572,NEGATIVE,8299,9058,8169,138,2098,5777
899-LILLY ELI _ CO.txt,42020,37105,4915,POSITIVE,15781,21375,-5594,NEGATIVE,8320,9074,8187,138,2103,5790
900-LINCOLN EDUCATIONAL SERVICES CORP.txt,42091,37178,4913,POSITIVE,15811,21414,-5603,NEGATIVE,8334,9086,8205,139,2107,5800
"902-LINN ENERGY, LLC.txt",42195,37267,4928,POSITIVE,15853,21469,-5616,NEGATIVE,8352,9105,8228,140,2112,5814
903-LIONBRIDGE TECHNOLOGIES INC  DE.txt,42340,37380,4960,POSITIVE,15923,21535,-5612,NEGATIVE,8375,9132,8249,140,2121,5827
904-LIQUIDITY SERVICES INC.txt,42413,37466,4947,POSITIVE,15953,21591,-5638,NEGATIVE,8394,9148,8271,140,2123,5837
906-LITHIA MOTORS INC.txt,42527,37587,4940,POSITIVE,15994,21687,-5693,NEGATIVE,8420,9187,8294,140,2131,5856
907-LITTELFUSE INC  DE.txt,42620,37672,4948,POSITIVE,16022,21733,-5711,NEGATIVE,8433,9212,8314,140,2137,5868
911-LOCKHEED MARTIN CORP.txt,42760,37793,4967,POSITIVE,16070,21805,-5735,NEGATIVE,8459,9242,8349,141,2145,5883
912-LOEWS CORP.txt,42842,37873,4969,POSITIVE,16094,21863,-5769,NEGATIVE,8476,9266,8359,141,2150,5894
914-LPL Financial Holdings Inc..txt,42956,37970,4986,POSITIVE,16143,21928,-5785,NEGATIVE,8500,9297,8377,141,2154,5907
920-LaSalle Hotel Properties.txt,43085,38074,5011,POSITIVE,16187,21986,-5799,NEGATIVE,8526,9329,8399,142,2163,5923
925-Limoneira CO.txt,43164,38144,5020,POSITIVE,16212,22015,-5803,NEGATIVE,8542,9353,8414,142,2164,5933
928-Lumos Networks Corp..txt,43263,38230,5033,POSITIVE,16246,22064,-5818,NEGATIVE,8557,9380,8432,142,2169,5947
93-COMPENSATION DISCUSSION AND ANALYSIS.txt,43281,38255,5026,POSITIVE,16248,22072,-5824,NEGATIVE,8558,9382,8432,142,2169,5951
930-LyondellBasell Industries N.V..txt,43404,38380,5024,POSITIVE,16301,22158,-5857,NEGATIVE,8584,9414,8450,142,2176,5967
935-MAGELLAN MIDSTREAM PARTNERS LP.txt,43415,38386,5029,POSITIVE,16306,22161,-5855,NEGATIVE,8584,9414,8451,142,2176,5968
936-MAINSOURCE FINANCIAL GROUP.txt,43489,38471,5018,POSITIVE,16339,22201,-5862,NEGATIVE,8599,9430,8464,142,2182,5977
94-ANALOG DEVICES INC.txt,43577,38551,5026,POSITIVE,16376,22245,-5869,NEGATIVE,8612,9447,8477,142,2186,5987
941-MARATHON OIL CORP.txt,43673,38647,5026,POSITIVE,16409,22289,-5880,NEGATIVE,8636,9467,8503,142,2190,5998
944-MARINEMAX INC.txt,43738,38706,5032,POSITIVE,16434,22313,-5879,NEGATIVE,8651,9480,8515,142,2193,6009
945-MARINUS PARMACEUTICALS INC.txt,43790,38782,5008,POSITIVE,16450,22370,-5920,NEGATIVE,8655,9513,8526,142,2196,6017
946-MARKEL CORP.txt,43878,38860,5018,POSITIVE,16482,22410,-5928,NEGATIVE,8673,9530,8547,142,2200,6030
948-MASONITE INTERNATIONAL CORP.txt,43991,38969,5022,POSITIVE,16516,22498,-5982,NEGATIVE,8698,9567,8566,142,2207,6043
953-MAXIMUS INC.txt,44094,39042,5052,POSITIVE,16564,22533,-5969,NEGATIVE,8716,9592,8580,142,2210,6057
957-MCCORMICK _ CO INC.txt,44157,39105,5052,POSITIVE,16581,22562,-5981,NEGATIVE,8725,9603,8588,143,2212,6066
959-MCGRAW HILL FINANCIAL INC.txt,44274,39236,5038,POSITIVE,16619,22662,-6043,NEGATIVE,8755,9635,8618,143,2219,6085
96-ANCHOR BANCORP WISCONSIN INC.txt,44369,39332,5037,POSITIVE,16657,22730,-6073,NEGATIVE,8776,9655,8639,144,2227,6105
961-MDU RESOURCES GROUP INC.txt,44471,39431,5040,POSITIVE,16694,22789,-6095,NEGATIVE,8802,9675,8662,145,2235,6117
967-METTLER TOLEDO INTERNATIONAL INC.txt,44544,39508,5036,POSITIVE,16718,22834,-6116,NEGATIVE,8825,9692,8680,145,2239,6131
97-ANWORTH MORTGAGE ASSET CORP.txt,44605,39582,5023,POSITIVE,16737,22871,-6134,NEGATIVE,8838,9706,8691,145,2243,6144
971-MGIC INVESTMENT CORP.txt,44723,39685,5038,POSITIVE,16777,22941,-6164,NEGATIVE,8880,9733,8715,145,2249,6166
974-MIDDLEBURG FINANCIAL CORP.txt,44827,39780,5047,POSITIVE,16810,22992,-6182,NEGATIVE,8899,9763,8741,147,2256,6181
975-MITEK STSTEMS INC.txt,44920,39875,5045,POSITIVE,16832,23064,-6232,NEGATIVE,8917,9789,8764,147,2264,6192
979-MOLINA HEALTHCARE INC.txt,44977,39937,5040,POSITIVE,16852,23084,-6232,NEGATIVE,8923,9802,8776,148,2268,6195
980-MONMOUTH REAL ESTATE INVESTMENT CORP.txt,45062,40009,5053,POSITIVE,16880,23115,-6235,NEGATIVE,8942,9815,8790,148,2270,6207
981-MOODYS CORP  DE.txt,45193,40104,5089,POSITIVE,16936,23173,-6237,NEGATIVE,8973,9844,8808,148,2277,6222
983-MOTORCAR PARTS AMERICA INC.txt,45262,40160,5102,POSITIVE,16959,23201,-6242,NEGATIVE,8983,9865,8824,148,2279,6230
984-MRC GLOBAL INC..txt,45306,40222,5084,POSITIVE,16989,23224,-6235,NEGATIVE,8992,9870,8836,148,2284,6237
985-MSA Safety Inc.txt,45441,40332,5109,POSITIVE,17040,23297,-6257,NEGATIVE,9015,9892,8859,149,2294,6255
986-MSCI Inc..txt,45556,40423,5133,POSITIVE,17092,23355,-6263,NEGATIVE,9039,9921,8884,149,2300,6270
987-MUELLER INDUSTRIES INC.txt,45643,40495,5148,POSITIVE,17123,23391,-6268,NEGATIVE,9050,9940,8900,149,2305,6282
989-MURPHY OIL CORP  DE.txt,45772,40600,5172,POSITIVE,17159,23448,-6289,NEGATIVE,9065,9967,8929,149,2309,6297
990-MUTUALFIRST FINANCIAL INC.txt,45834,40650,5184,POSITIVE,17175,23465,-6290,NEGATIVE,9076,9976,8940,149,2310,6306
"993-Maiden Holdings, Ltd..txt",45917,40714,5203,POSITIVE,17212,23487,-6275,NEGATIVE,9087,9993,8951,149,2312,6316
996-Mallinckrodt plc.txt,46017,40803,5214,POSITIVE,17245,23541,-6296,NEGATIVE,9111,10005,8970,149,2317,6326
998-Marathon Petroleum Corp.txt,46137,40929,5208,POSITIVE,17284,23617,-6333,NEGATIVE,9138,10034,8993,150,2327,6342
